Fuzziolump
An Interactive Fiction by jeff creswell
Release 1 / Serial number 190517 / Inform 7 build 6M62 (I6/v6.33 lib 6/12N) SD

Chamber of Soiled Vestments
The musty warmth of the laundry room has always appealed to you; it suggests a friendly invitation to the unknown, and there always seems to be another unexplored dark corner.  Plus it's always warm and the soft tumbling of the dryers is soothing.  You smile contentedly at this thought, imagining that few people bother to appreciate the subtle treasures in a blanket of soft shadow.  A shared laundry like the one in your building is exponentially better, since every traveler through it leaves a little bit of themselves behind, enlivening the story.  If you were the type to rifle throw other people's skivvies it might be livelier-still, but that's intrusive. Also gross.  The dryer rumbles to a halt, then buzzes obnoxiously.  The world sure seems to love its noise.

You can see a Table (closed) and a Dryer (closed) here.

>save
Ok.

* * *

>look
Chamber of Soiled Vestments
You stand in the laundry room.  A speck of lint drifts by, placidly.

You can see a Table (closed) and a Dryer (closed) here.

>open table
It isn't something you can open.

>open Table
It isn't something you can open.

>open Dryer
It isn't something you can open.

>take clothes
Taken.

>look
Chamber of Soiled Vestments
You can see a Table (empty) and a Dryer (empty) here.

* * *

>look
Chamber of Soiled Vestments
You stand in the laundry room.  A speck of lint drifts by, placidly.

You can see a Table (closed) and a Dryer (closed) here.

>w
You can't go that way.

>look
Chamber of Soiled Vestments
You can see a Table (closed) and a Dryer (closed) here.

* * *

>look
Chamber of Soiled Vestments
You stand in the laundry room.  A speck of lint drifts by, placidly.

You can see a Table (closed) and a Dryer (closed) here.

>look
Chamber of Soiled Vestments
You stand in the laundry room.  A speck of lint drifts by, placidly.

You can see a Table (closed) and a Dryer (closed) here.

>open dryer
You open the Dryer, revealing Clothes.

>take clothes
Ducking down peer to inside, you're greeted by a pleasant surprise -- your clothes are fully dry for once!  As you pull clothes from the dryer and pile them in your hamper, you note that only a single sock of your favorite pair is present and accounted for. They're the super-fuzzy wooly kind, and are patterned with kittens playing with balls of yarn on one and puppies chasing sticks on the other.  Looking down at the lonely puppy sock, your heart aches a little.  Poor guy.  Practically climbing halfway into the dryer, you reach and flail about for the errant kitten sock to no avail.

Re-adjusting yourself, you poke your head in to take a closer look, expecting ruefully to see only empty dryer walls. Instead, you see the head, forelegs, and fuzzy whiskers of an otter staring at you with anxiety quaking in its fathomless black eyes.  He's wearing a darling little tophat, bowtie, and a gold-rimmed monocle adorns one eye.  Before you can react, he boops your nose with a soft paw, his expression apprehensive. After a bizarre moment staring at each other in this manner, reality begins to spin and you fear someone has turned the dryer on with you halfway inside!  You close your eyes, bracing for the inevitable pain as you evaluate the strength of the dryer's tumble cycle first-hand.  There's no pain, however, and after only a few dizzying seconds the world stills.

Atrium Glade
Only, it's a different world than the one you left.  A cool breeze and the unmistakable smell of pine needles coaxes you to open your eyes.

You find yourself in a wintry forest glade. Evergreen foliage, bearing a light sprinkling of snow such that it resembles sugar-dusted sweets, surrounds you.  The otter, which sports a pair of fluffy brown wings the same shade as its sleek tawny fur, flits about your head, appraisingly.  His little tophat tilts gently back and forth in a hypnotizing pattern, in time with the rhythm of his lazy wing beats.

A holly bush rustles thoughtfully in the wind.

>look
Atrium Glade
A refreshing cool breeze carresses your cheek and ruffles the wintergreen foliage.  Only the gentle fwump fwump of the otter's wings breaks the tranquil silence, a comforting constant.

A holly bush rustles thoughtfully in the wind.

>look
Atrium Glade
A refreshing cool breeze carresses your cheek and ruffles the wintergreen foliage.  Only the gentle fwump fwump of the otter's wings breaks the tranquil silence, a comforting constant.

A holly bush rustles thoughtfully in the wind.

>look bush
You examine the nearest frosted greenery, a holly bush whose bright red berries contrast beautifully with the pure white snow.  Brushing a hand over the bush idly, you jump higher than you thought possible when one of its branches extends creakily and a sprig reaches out to pat you right back.  As if taken aback and perhaps chagrined by your startled reaction, the branch withdraws shyly, and the sprig of holly flutters gently to the ground.

* * *

>open table
You open the Table, revealing a 9-volt Battery, a Singed Penny and a Rusty Pocket Knife.

>open Table
That's already open.

>look at dryer
You see nothing special about the Dryer.

>open dryer
You open the Dryer, revealing Clothes.

* * *

>look at holly
hello.
You examine the nearest frosted greenery, a holly bush whose bright red berries contrast beautifully with the pure white snow.  Brushing a hand over the bush idly, you jump higher than you thought possible when one of its branches extends creakily and a sprig reaches out to pat you right back.  As if taken aback and perhaps chagrined by your startled reaction, the branch withdraws shyly, and the sprig of holly flutters gently to the ground.

* * *

>open table
You open the Table, revealing a 9-volt Battery, a Singed Penny and a Rusty Pocket Knife.

>look
Chamber of Soiled Vestments
You can see a Table (empty) and a Dryer (closed) here.

>open dryer
You open the Dryer, revealing Clothes.

>look
Chamber of Soiled Vestments
You can see a Table (empty) and a Dryer (in which is Clothes) here.

>take clothes
Taken.

>take clothes
You already have that.

>look
Chamber of Soiled Vestments
You can see a Table (empty) and a Dryer (empty) here.

* * *

>open table
You open the Table, revealing a 9-volt Battery, a Singed Penny and a Rusty Pocket Knife.

>look at 9-volt battery
Time and tide (by the look of it, it has actually been swimming) have not been kind to this old fellow, but he might still have some juice left.

* * *

>examine table
You see nothing special about the Table.

* * *

>open dryer
You open the Dryer, revealing Clothes.

>take clothers
You can't see any such thing.

>take clothes
Ducking down peer to inside, you're greeted by a pleasant surprise -- your clothes are fully dry for once!  As you pull clothes from the dryer and pile them in your hamper, you note that only a single sock of your favorite pair is present and accounted for. They're the super-fuzzy wooly kind, and are patterned with kittens playing with balls of yarn on one and puppies chasing sticks on the other.  Looking down at the lonely puppy sock, your heart aches a little.  Poor guy.  Practically climbing halfway into the dryer, you reach and flail about for the errant kitten sock to no avail.

Re-adjusting yourself, you poke your head in to take a closer look, expecting ruefully to see only empty dryer walls. Instead, you see the head, forelegs, and fuzzy whiskers of an otter staring at you with anxiety quaking in its fathomless black eyes.  He's wearing a darling little tophat, bowtie, and a gold-rimmed monocle adorns one eye.  Before you can react, he boops your nose with a soft paw, his expression apprehensive. After a bizarre moment staring at each other in this manner, reality begins to spin and you fear someone has turned the dryer on with you halfway inside!  You close your eyes, bracing for the inevitable pain as you evaluate the strength of the dryer's tumble cycle first-hand.  There's no pain, however, and after only a few dizzying seconds the world stills.

Atrium Glade
Only, it's a different world than the one you left.  A cool breeze and the unmistakable smell of pine needles coaxes you to open your eyes.

You find yourself in a wintry forest glade. Evergreen foliage, bearing a light sprinkling of snow such that it resembles sugar-dusted sweets, surrounds you.  The otter, which sports a pair of fluffy brown wings the same shade as its sleek tawny fur, flits about your head, appraisingly.  His little tophat tilts gently back and forth in a hypnotizing pattern, in time with the rhythm of his lazy wing beats.

A holly bush rustles thoughtfully in the wind.

>look
Chamber of Soiled Vestments
You stand in the laundry room.  A speck of lint drifts by, placidly.

You can see a Table (closed) and a Dryer (in which is Clothes) here.

>take clothes
thing.

* * *

>look at bush
You examine the nearest frosted greenery, a holly bush whose bright red berries contrast beautifully with the pure white snow.  Brushing a hand over the bush idly, you jump higher than you thought possible when one of its branches extends creakily and a sprig reaches out to pat you right back.  As if taken aback and perhaps chagrined by your startled reaction, the branch withdraws shyly, and the sprig of holly flutters gently to the ground.

>look
Atrium Glade
Only, it's a different world than the one you left.  A cool breeze and the unmistakable smell of pine needles coaxes you to open your eyes.

You find yourself in a wintry forest glade. Evergreen foliage, bearing a light sprinkling of snow such that it resembles sugar-dusted sweets, surrounds you.  The otter, which sports a pair of fluffy brown wings the same shade as its sleek tawny fur, flits about your head, appraisingly.  His little tophat tilts gently back and forth in a hypnotizing pattern, in time with the rhythm of his lazy wing beats.

A holly bush rustles thoughtfully in the wind.

You can also see a Sprig of Holly here.

>look at sprig
You see nothing special about the Sprig of Holly.

* * *

>open dryer
You open the Dryer, revealing Clothes.

>take clothes
Ducking down peer to inside, you're greeted by a pleasant surprise -- your clothes are fully dry for once!  As you pull clothes from the dryer and pile them in your hamper, you note that only a single sock of your favorite pair is present and accounted for. They're the super-fuzzy wooly kind, and are patterned with kittens playing with balls of yarn on one and puppies chasing sticks on the other.  Looking down at the lonely puppy sock, your heart aches a little.  Poor guy.  Practically climbing halfway into the dryer, you reach and flail about for the errant kitten sock to no avail.

Re-adjusting yourself, you poke your head in to take a closer look, expecting ruefully to see only empty dryer walls. Instead, you see the head, forelegs, and fuzzy whiskers of an otter staring at you with anxiety quaking in its fathomless black eyes.  He's wearing a darling little tophat, bowtie, and a gold-rimmed monocle adorns one eye.  Before you can react, he boops your nose with a soft paw, his expression apprehensive. After a bizarre moment staring at each other in this manner, reality begins to spin and you fear someone has turned the dryer on with you halfway inside!  You close your eyes, bracing for the inevitable pain as you evaluate the strength of the dryer's tumble cycle first-hand.  There's no pain, however, and after only a few dizzying seconds the world stills.

Atrium Glade
Only, it's a different world than the one you left.  A cool breeze and the unmistakable smell of pine needles coaxes you to open your eyes.

You find yourself in a wintry forest glade. Evergreen foliage, bearing a light sprinkling of snow such that it resembles sugar-dusted sweets, surrounds you

A holly bush rustles thoughtfully in the wind.

A winged otter flaps serenely nearby.  His tophat is dapper.

>look
Atrium Glade
A refreshing cool breeze carresses your cheek and ruffles the wintergreen foliage.  Only the gentle fwump fwump of the otter's wings breaks the tranquil silence, a comforting constant.

A holly bush rustles thoughtfully in the wind.

The otter, who sports a pair of fluffy brown wings the same shade as its sleek tawny fur, flits about your head, appraisingly.  His little tophat tilts gently back and forth in a hypnotizing pattern, in time with the rhythm of his lazy wing beats.  It is the dapper-est.

>look
Chamber of Soiled Vestments
You stand in the laundry room.  A speck of lint drifts by, placidly.

You can see a Table (closed) and a Dryer (in which is Clothes) here.

* * *

>look
Atrium Glade
A refreshing cool breeze carresses your cheek and ruffles the wintergreen foliage.  Only the gentle fwump fwump of the otter's wings breaks the tranquil silence, a comforting constant.

A holly bush rustles thoughtfully in the wind.

The otter, who sports a pair of fluffy brown wings the same shade as its sleek tawny fur, flits about your head, appraisingly.  His little tophat tilts gently back and forth in a hypnotizing pattern, in time with the rhythm of his lazy wing beats.  It is the dapper-est.

>look holly
You examine the nearest frosted greenery, a holly bush whose bright red berries contrast beautifully with the pure white snow.  Brushing a hand over the bush idly, you jump higher than you thought possible when one of its branches extends creakily and a sprig reaches out to pat you right back.  As if taken aback and perhaps chagrined by your startled reaction, the branch withdraws shyly, and the sprig of holly flutters gently to the ground.

>i
You are carrying:
  a Sprig of Holly

* * *

>look
Atrium Glade
A refreshing cool breeze carresses your cheek and ruffles the wintergreen foliage.  Only the gentle fwump fwump of the otter's wings breaks the tranquil silence, a comforting constant.

A holly bush rustles thoughtfully in the wind.

The otter, who sports a pair of fluffy brown wings the same shade as its sleek tawny fur, flits about your head, appraisingly.  His little tophat tilts gently back and forth in a hypnotizing pattern, in time with the rhythm of his lazy wing beats.  It is the dapper-est.

>examine otter
You can't see any such thing.

>examine Nuvi
You see nothing special about Nuvi.

>look
Atrium Glade
A refreshing cool breeze carresses your cheek and ruffles the wintergreen foliage.  Only the gentle fwump fwump of the otter's wings breaks the tranquil silence, a comforting constant.

A holly bush rustles thoughtfully in the wind.

The otter, who sports a pair of fluffy brown wings the same shade as its sleek tawny fur, flits about your head, appraisingly.  His little tophat tilts gently back and forth in a hypnotizing pattern, in time with the rhythm of his lazy wing beats.  It is the dapper-est.

* * *

>look at bush
You examine the nearest frosted greenery, a holly bush whose bright red berries contrast beautifully with the pure white snow.  Brushing a hand over the bush idly, you jump higher than you thought possible when one of its branches extends creakily and a sprig reaches out to pat you right back.  As if taken aback and perhaps chagrined by your startled reaction, the branch withdraws shyly, and the sprig of holly flutters gently to the ground.

>look
Atrium Glade
Only, it's a different world than the one you left.  A cool breeze and the unmistakable smell of pine needles coaxes you to open your eyes.

You find yourself in a wintry forest glade. Evergreen foliage, bearing a light sprinkling of snow such that it resembles sugar-dusted sweets, surrounds you.  The otter, which sports a pair of fluffy brown wings the same shade as its sleek tawny fur, flits about your head, appraisingly.  His little tophat tilts gently back and forth in a hypnotizing pattern, in time with the rhythm of his lazy wing beats.

A sprig of holly rests nearby.  A shy little memento of the frosted forest, it has a single pointy leaf and a single berry the color of a cheerful blush.  A gust of wind pushes it gently towards you.

A holly bush rustles thoughtfully in the wind.

>look at bush
You examine the nearest frosted greenery, a holly bush whose bright red berries contrast beautifully with the pure white snow.  Brushing a hand over the bush idly, you jump higher than you thought possible when one of its branches extends creakily and a sprig reaches out to pat you right back.  As if taken aback and perhaps chagrined by your startled reaction, the branch withdraws shyly, and the sprig of holly flutters gently to the ground.

* * *

>take sprig
Taken.

>look
Atrium Glade
Only, it's a different world than the one you left.  A cool breeze and the unmistakable smell of pine needles coaxes you to open your eyes.

You find yourself in a wintry forest glade. Evergreen foliage, bearing a light sprinkling of snow such that it resembles sugar-dusted sweets, surrounds you.  The otter, which sports a pair of fluffy brown wings the same shade as its sleek tawny fur, flits about your head, appraisingly.  His little tophat tilts gently back and forth in a hypnotizing pattern, in time with the rhythm of his lazy wing beats.

A holly bush rustles thoughtfully in the wind.

>look at bush
You examine the nearest frosted greenery, a holly bush whose bright red berries contrast beautifully with the pure white snow.  Brushing a hand over the bush idly, you jump higher than you thought possible when one of its branches extends creakily and a sprig reaches out to pat you right back.  As if taken aback and perhaps chagrined by your startled reaction, the branch withdraws shyly, and the sprig of holly flutters gently to the ground.

* * *

>i
You are carrying nothing.

>look at sprig
You see nothing special about the Sprig of Holly.

* * *

>look at sprig
A sprig of holly rests nearby.  A shy little memento of the frosted forest, it has a single pointy leaf and a single berry the color of a cheerful blush.  A gust of wind pushes it gently towards you.

* * *

>look bush
You examine the nearest frosted greenery, a holly bush whose bright red berries contrast beautifully with the pure white snow.  Brushing a hand over the bush idly, you jump higher than you thought possible when one of its branches extends creakily and a sprig reaches out to pat you right back.  As if taken aback and perhaps chagrined by your startled reaction, the branch withdraws shyly, and the sprig of holly flutters gently to the ground.

>look
Atrium Glade
Only, it's a different world than the one you left.  A cool breeze and the unmistakable smell of pine needles coaxes you to open your eyes.

You find yourself in a wintry forest glade. Evergreen foliage, bearing a light sprinkling of snow such that it resembles sugar-dusted sweets, surrounds you.  The otter, which sports a pair of fluffy brown wings the same shade as its sleek tawny fur, flits about your head, appraisingly.  His little tophat tilts gently back and forth in a hypnotizing pattern, in time with the rhythm of his lazy wing beats.

A sprig of holly rests nearby.  Sighs of feminine longing and entreaty in a thousand thousand voices whisper on a sudden gust of wind that pushes it gently towards you.

A holly bush rustles thoughtfully in the wind.

>look
Atrium Glade
Only, it's a different world than the one you left.  A cool breeze and the unmistakable smell of pine needles coaxes you to open your eyes.

You find yourself in a wintry forest glade. Evergreen foliage, bearing a light sprinkling of snow such that it resembles sugar-dusted sweets, surrounds you.  The otter, which sports a pair of fluffy brown wings the same shade as its sleek tawny fur, flits about your head, appraisingly.  His little tophat tilts gently back and forth in a hypnotizing pattern, in time with the rhythm of his lazy wing beats.

A sprig of holly rests nearby.  Sighs of feminine longing and entreaty in a thousand thousand voices whisper on a sudden gust of wind that pushes it gently towards you.

A holly bush rustles thoughtfully in the wind.

>look at sprig
A shy little memento of the frosted forest, this bit of holly has a single pointy leaf and a single berry the color of a cheerful blush.

>look
Atrium Glade
Only, it's a different world than the one you left.  A cool breeze and the unmistakable smell of pine needles coaxes you to open your eyes.

You find yourself in a wintry forest glade. Evergreen foliage, bearing a light sprinkling of snow such that it resembles sugar-dusted sweets, surrounds you.  The otter, which sports a pair of fluffy brown wings the same shade as its sleek tawny fur, flits about your head, appraisingly.  His little tophat tilts gently back and forth in a hypnotizing pattern, in time with the rhythm of his lazy wing beats.

A sprig of holly rests nearby.  Sighs of feminine longing and entreaty in a thousand thousand voice whisper on a sudden gust of wind that pushes it gently towards you.

A holly bush rustles thoughtfully in the wind.

>take sprig
Taken.

* * *

>i
You are carrying:
  a Sprig of Holly

>look sprig
A shy little memento of the frosted forest, this bit of holly has a single pointy leaf and a single berry the color of a cheerful blush.

* * *

>look sprig
A shy little memento of the frosted forest, this bit of holly has a single pointy leaf and a single berry the color of a cheerful blush.  Whenever you touch it, a light puff of wind kisses your cheek, carrying the ghost of a flirty giggle.

>look
Atrium Glade
Only, it's a different world than the one you left.  A cool breeze and the unmistakable smell of pine needles coaxes you to open your eyes.

You find yourself in a wintry forest glade. Evergreen foliage, bearing a light sprinkling of snow such that it resembles sugar-dusted sweets, surrounds you.  The otter, which sports a pair of fluffy brown wings the same shade as its sleek tawny fur, flits about your head, appraisingly.  His little tophat tilts gently back and forth in a hypnotizing pattern, in time with the rhythm of his lazy wing beats.

A sprig of holly rests nearby.  Sighs of feminine longing and entreaty in a thousand thousand voices whisper on a sudden gust of wind that pushes it gently towards you.

A holly bush rustles thoughtfully in the wind.

>look bush
The Holly Bush waves serenely in the languid wind, and at you.  Every now and then it forgets itself and waves against the wind.

>look
Atrium Glade
Only, it's a different world than the one you left.  A cool breeze and the unmistakable smell of pine needles coaxes you to open your eyes.

You find yourself in a wintry forest glade. Evergreen foliage, bearing a light sprinkling of snow such that it resembles sugar-dusted sweets, surrounds you.  The otter, which sports a pair of fluffy brown wings the same shade as its sleek tawny fur, flits about your head, appraisingly.  His little tophat tilts gently back and forth in a hypnotizing pattern, in time with the rhythm of his lazy wing beats.

A sprig of holly rests nearby.  Sighs of feminine longing and entreaty in a thousand thousand voices whisper on a sudden gust of wind that pushes it gently towards you.

A holly bush rustles thoughtfully in the wind.

>take sprig
Taken.

* * *

>look sprig
A shy little memento of the frosted forest, this bit of holly has a single pointy leaf and a single berry the color of a cheerful blush.  Whenever you touch it, a light puff of wind kisses your cheek, carrying the ghost of a flirty giggle.

* * *

>look bush
The Holly Bush waves serenely in the languid wind, and at you.  Every now and then it forgets itself and waves against the wind.

>look sprig
A shy little memento of the frosted forest, this bit of holly has a single pointy leaf and a single berry the color of a cheerful blush.  Whenever you touch it, a light puff of wind kisses your cheek, carrying the ghost of a flirty giggle.

>take sprig
Taken.

>i
You are carrying:
  a Sprig of Holly

>look sprig
A shy little memento of the frosted forest, this bit of holly has a single pointy leaf and a single berry the color of a cheerful blush.  Whenever you touch it, a light puff of wind kisses your cheek, carrying the ghost of a flirty giggle.

* * *

>n
As you try to move away, the winged otter flaps down to block your path, doffing his dapper tophat to you and waving a soft paw shyly.

* * *

>say creativity
(to Nuvi)
"Really?!  I thought it was a longshot, honestly, that you would be able to control elemental creativity!  Well, the Council of Animals will be thrilled."  He does a barrel roll and flits about your head, joyously.  Shame on you for lying to such an innocent creature!
prior to unlikely magic, Nuvi's fondness for the player has an amplitude of 0after unlikely magic, Nuvi's fondness for the player has an amplitude of 5

>look
Atrium Glade
A refreshing cool breeze carresses your cheek and ruffles the wintergreen foliage.  Only the gentle fwump fwump of the otter's wings breaks the tranquil silence, a comforting constant. You can see a path in the thick forest leading North.  Nuvi eyes it meaningfully.

A holly bush rustles thoughtfully in the wind.

A winged otter flaps serenely nearby.  His tophat is dapper.

>n
Bejeweled Pines
glittery pines TODO.

>look
Bejeweled Pines
glittery pines TODO.

* * *

>speak to otter
I didn't understand that sentence.

>actions
Actions listing on.

>say "hello" to otter
You can only do that to something animate.

* * *

>actions
Actions listing on.

>speak to otter
I didn't understand that sentence.

>speak to winged otter
I didn't understand that sentence.

>say "hello" to otter
[answering the Winged Otter that "" hello ""]
There is no reply.
[answering the Winged Otter that "" hello "" - succeeded]

* * *

>actions
Actions listing on.

>say hello to Nuvi
[answering Nuvi that "hello"]
The Winged Otter beams at you.  "Hello, there Human!  My name is Nuvi."
[answering Nuvi that "hello" - succeeded]

* * *

>say hello to Nuvi
There is no reply.

>s
You can't go that way.

* * *

>s
The winged otter flaps down to block your path, doffing his dapper tophat to you each time and extending a soft paw to shake.

>s
The winged otter flaps down to block your path, doffing his dapper tophat to you each time and extending a soft paw to shake.

>say hello to Nuvi
The Winged Otter beams at you.  "Hello, there Human!  My name is Nuvi."

>s
You can't go that way.

* * *

>l
Atrium Glade
A refreshing cool breeze carresses your cheek and ruffles the wintergreen foliage.  Only the gentle fwump fwump of the otter's wings breaks the tranquil silence, a comforting constant.

A holly bush rustles thoughtfully in the wind.

The otter, who sports a pair of fluffy brown wings the same shade as its sleek tawny fur, flits about your head, appraisingly.  His little tophat tilts gently back and forth in a hypnotizing pattern, in time with the rhythm of his lazy wing beats.  It is the dapper-est.

* * *

>look Shimmerin
You see nothing special about Shimmerin.

* * *

>say no creativity
(to Nuvi)
His little whiskers droop, and his tophat slides down over his eyes. Pushing it back up into place, he responds, "Oh.  Well, I can't say I'm surprised that you're not able to control elemental creativity.  We'd always hoped that Humanity, as our sires and kinda sorta ancestor god type of things, would be... I dunno, super-crazy-magic, I guess.  That's a childish assumption, however, and there's surely nothing for children in Fuzziolump!"  His snoot wiggles thoughtfully, and then his whiskers spring up so fast they bounce. "Ah well!  It is the nature of things to generally be more realistic than we imagine them, unless of course we're actually imagining them into reality."  He grins at you, as if this was a perfectly normal sentence. "Come on then, let's go see the Council of Animals anyway -- I'm sure you can help us somehow!  They're off North, beyond the Frosted Forest's edge in the sandy savannah of the Wombat Warrens."

>n
yourself shuffles along after the player.

Bejeweled Pines
You stand amongst a dazzling array of colors: these trees are Fancy.

the trees here are no less dusted with snow than their fellows you just pushed through, but they have also been festooned with crystal and glass baubles of every conceivable hue.  Little soft-glowing lights flit from ornament to ornament, keeping the emphasis and shading dynamic.

Nuvi shuffles along after the player.

Bejeweled Pines
You stand amongst a dazzling array of colors: these trees are Fancy.

A winged otter flaps serenely nearby.  His tophat is dapper.

the trees here are no less dusted with snow than their fellows you just pushed through, but they have also been festooned with crystal and glass baubles of every conceivable hue.  Little soft-glowing lights flit from ornament to ornament, keeping the emphasis and shading dynamic.

>look
Bejeweled Pines
You stand amongst a dazzling array of colors: these trees are Fancy.

>ask Nuvi about trees
You can't see any such thing.

>actions
Actions listing on.

>ask Nuvi about trees
You can't see any such thing.

>ask Nuvi
You can't see any such thing.

>ask trees
You can't see any such thing.

>ask about trees
You can't see any such thing.

* * *

>look tree
Baubles and glorious gizmos adorn the trees all around this grove.  It may just be you, but they seem to be preening in so far as plants can pose.
nothing

>look
Bejeweled Pines
You stand amongst a dazzling array of colors: these trees are Fancy.

A winged otter flaps serenely nearby.  His tophat is dapper.

the trees here are no less dusted with snow than their fellows you just pushed through, but they have also been festooned with crystal and glass baubles of every conceivable hue.  Little soft-glowing lights flit from ornament to ornament, keeping the emphasis and shading dynamic.

>look tree
Upon closer inspection of a nearby tree, glittering with tinsel made from filaments of actual silver, you note a pair of brilliant green eyes in a feminine face blinking curiously at you from the bark of a nearby tree.  What you had taken to be an odd crystalline growth on the side of the tree resolves itself to be an amethyst necklace cascading down her decolletage like a waterfall's wildness stilled by the gentling influence of frost.  When you raise your eyes to hers again, you find her arching an eyebrow at you.

* * *

>nuvio
That's not a verb I recognise.

>say no creativity to nuvi
There is no reply.

>n
Bejeweled Pines
You stand amongst a dazzling array of colors: these trees are Fancy.

the trees here are no less dusted with snow than their fellows you just pushed through, but they have also been festooned with crystal and glass baubles of every conceivable hue.  Little soft-glowing lights flit from ornament to ornament, keeping the emphasis and shading dynamic.

>look tree
Baubles and glorious gizmos adorn the trees all around this grove.  It may just be you, but they seem to be preening in so far as plants can pose.
the Bejeweled Pines

* * *

>n
Bejeweled Pines
You stand amongst a dazzling array of colors: these trees are Fancy.

the trees here are no less dusted with snow than their fellows you just pushed through, but they have also been festooned with crystal and glass baubles of every conceivable hue.  Little soft-glowing lights flit from ornament to ornament, keeping the emphasis and shading dynamic.

>look nuvi
You can't see any such thing.

* * *

>look tree
Upon closer inspection of a nearby tree, glittering with tinsel made from filaments of actual silver, you note a pair of brilliant green eyes in a feminine face blinking curiously at you from the bark of a nearby tree.  What you had taken to be an odd crystalline growth on the side of the tree resolves itself to be an amethyst necklace cascading down her decolletage like a waterfall's wildness stilled by the gentling influence of frost.  When you raise your eyes to hers again, you find her arching an eyebrow at you.

>look tree
Baubles and glorious gizmos adorn the trees all around this grove.  It may just be you, but they seem to be preening in so far as plants can pose.

>look
Bejeweled Pines
You stand amongst a dazzling array of colors: these trees are Fancy.

A gorgeous dryad peeks out from a nearby tree, curiously.

A winged otter flaps serenely nearby.  His tophat is dapper.

the trees here are no less dusted with snow than their fellows you just pushed through, but they have also been festooned with crystal and glass baubles of every conceivable hue.  Little soft-glowing lights flit from ornament to ornament, keeping the emphasis and shading dynamic.

>look dryad
You can't see any such thing.

>look Willoweave
You see nothing special about Willoweave.

>say hiya to Willoweave
The pretty young dryad cringes away as you focus on her, throwing up an arm of wood smooth as glass to shield herself from your wrath and violence.  After a moment passes peacefully, albeit awkwardly, she lowers her arm and blinks at you in surprise. "Mother always told us that Outsiders are deadly dangerous things.  You don't seem terribly murderous."  Her own words lend her courage, and she approaches steadily.  When she reaches you and is still alive, she plants herself well within your personal space and immediately begins a thorough investigation of your squishy person.  "You're so soft!" she giggles delightedly, poking and pinching any exposed flesh she can find on you.  "And you're not very hairy, so I can see so much detail!  Take your clothes off, please."  She starts to pull at your clothing when Nuvi swoops down and whacks her on the head with his hat.  Her wild mane of ivy and thistle down cushions the blow, but she steps back anyway, thoroughly rebuked.  "Sorry about that; got overexcited. If I promise not to poke you much without asking first, can I travel with your for a bit?  I wanna see everything!"  

Willoweave has inserted herself into the party.

>look
Bejeweled Pines
You stand amongst a dazzling array of colors: these trees are Fancy.

Willoweave bounces on her rainbow-painted roots enthusiastically, eager to see what's next.

A winged otter flaps serenely nearby.  His tophat is dapper.

the trees here are no less dusted with snow than their fellows you just pushed through, but they have also been festooned with crystal and glass baubles of every conceivable hue.  Little soft-glowing lights flit from ornament to ornament, keeping the emphasis and shading dynamic.

* * *

>look
Bejeweled Pines
You stand amongst a dazzling array of colors: these trees are Fancy.

A winged otter flaps serenely nearby.  His tophat is dapper.

the trees here are no less dusted with snow than their fellows you just pushed through, but they have also been festooned with crystal and glass baubles of every conceivable hue.  Little soft-glowing lights flit from ornament to ornament, keeping the emphasis and shading dynamic.

>look trees
Upon closer inspection of a nearby tree, glittering with tinsel made from filaments of actual silver, you note a pair of brilliant green eyes in a feminine face blinking curiously at you from the bark of a nearby tree.  What you had taken to be an odd crystalline growth on the side of the tree resolves itself to be an amethyst necklace cascading down her decolletage like a waterfall's wildness stilled by the gentling influence of frost.  When you raise your eyes to hers again, you find her arching an eyebrow at you.

>look
Bejeweled Pines
You stand amongst a dazzling array of colors: these trees are Fancy.

A gorgeous dryad peeks out from a nearby tree, curiously.

A winged otter flaps serenely nearby.  His tophat is dapper.

the trees here are no less dusted with snow than their fellows you just pushed through, but they have also been festooned with crystal and glass baubles of every conceivable hue.  Little soft-glowing lights flit from ornament to ornament, keeping the emphasis and shading dynamic.

>look dryad
Emerald green ivy interspersed and accented by soft thistle down serves this dryad like hair, pouring down from her head well past the small of her back.  Soft tawny eyes peer out from a face ever-bright with wonder.  Her skin is the gleaming nut brown of polished oak, and is smoother to the touch than glass.  She has the shape of a human woman carved from wood, save that her feet and hands are more like the roots and branches of trees, respectively.  Most of the time she wears nothing, but when she catches you examinig her, crimson poppies burst into bloom on her cheeks and she summons up a modest dusting of moss to cover her torso like a dress.  A very clingy dress.

>say hi to dryad
The pretty young dryad cringes away as you focus on her, throwing up an arm of wood smooth as glass to shield herself from your wrath and violence.  After a moment passes peacefully, albeit awkwardly, she lowers her arm and blinks at you in surprise. "Mother always told us that Outsiders are deadly dangerous things.  You don't seem terribly murderous."  Her own words lend her courage, and she approaches steadily.  When she reaches you and is still alive, she plants herself well within your personal space and immediately begins a thorough investigation of your squishy person.  "You're so soft!" she giggles delightedly, poking and pinching any exposed flesh she can find on you.  "And you're not very hairy, so I can see so much detail!  Take your clothes off, please."  She starts to pull at your clothing when Nuvi swoops down and whacks her on the head with his hat.  Her wild mane of ivy and thistle down cushions the blow, but she steps back anyway, thoroughly rebuked.  "Sorry about that; got overexcited.  My name is Willoweave, and I'm ecstatic to meet you!  If I promise not to poke you much without asking first, can I travel with your for a bit?  I wanna see everything!"  

Willoweave has inserted herself into the party.

>look dryad
Emerald green ivy interspersed and accented by soft thistle down serves this dryad like hair, pouring down from her head well past the small of her back.  Soft tawny eyes peer out from a face ever-bright with wonder.  Her skin is the gleaming nut brown of polished oak, and is smoother to the touch than glass.  She has the shape of a human woman carved from wood, save that her feet and hands are more like the roots and branches of trees, respectively.  Most of the time she wears nothing, but when she catches you examinig her, crimson poppies burst into bloom on her cheeks and she summons up a modest dusting of moss to cover her torso like a dress.  A very clingy dress.

>look
Bejeweled Pines
You stand amongst a dazzling array of colors: these trees are Fancy.

Willoweave bounces on her rainbow-painted roots enthusiastically, eager to see what's next.

A winged otter flaps serenely nearby.  His tophat is dapper.

the trees here are no less dusted with snow than their fellows you just pushed through, but they have also been festooned with crystal and glass baubles of every conceivable hue.  Little soft-glowing lights flit from ornament to ornament, keeping the emphasis and shading dynamic.

* * *

>opend dryer
That's not a verb I recognise.

>open dryer
You open the Dryer, revealing Clothes.

* * *

>look
Bejeweled Pines
You stand amongst a dazzling array of colors: these trees are Fancy.

A winged otter flaps serenely nearby.  His tophat is dapper.

the trees here are no less dusted with snow than their fellows you just pushed through, but they have also been festooned with crystal and glass baubles of every conceivable hue.  Little soft-glowing lights flit from ornament to ornament, keeping the emphasis and shading dynamic.

>look
Bejeweled Pines
You stand amongst a dazzling array of colors: these trees are Fancy.

A winged otter flaps serenely nearby.  His tophat is dapper.

the trees here are no less dusted with snow than their fellows you just pushed through, but they have also been festooned with crystal and glass baubles of every conceivable hue.  Little soft-glowing lights flit from ornament to ornament, keeping the emphasis and shading dynamic.

>look light
You can't see any such thing.

>look tree
You can't see any such thing.

>look trees
Upon closer inspection of a nearby tree, glittering with tinsel made from filaments of actual silver, you note a pair of brilliant green eyes in a feminine face blinking curiously at you from the bark of a nearby tree.  What you had taken to be an odd crystalline growth on the side of the tree resolves itself to be an amethyst necklace cascading down her decolletage like a waterfall's wildness stilled by the gentling influence of frost.  When you raise your eyes to hers again, you find her arching an eyebrow at you.

>look trees
Upon closer inspection of a nearby tree, glittering with tinsel made from filaments of actual silver, you note a pair of brilliant green eyes in a feminine face blinking curiously at you from the bark of a nearby tree.  What you had taken to be an odd crystalline growth on the side of the tree resolves itself to be an amethyst necklace cascading down her decolletage like a waterfall's wildness stilled by the gentling influence of frost.  When you raise your eyes to hers again, you find her arching an eyebrow at you.

>look
Bejeweled Pines
You stand amongst a dazzling array of colors: these trees are Fancy.

A winged otter flaps serenely nearby.  His tophat is dapper.

the trees here are no less dusted with snow than their fellows you just pushed through, but they have also been festooned with crystal and glass baubles of every conceivable hue.  Little soft-glowing lights flit from ornament to ornament, keeping the emphasis and shading dynamic.

You can also see Willoweave here.

* * *

>look
Bejeweled Pines
You stand amongst a dazzling array of colors: these trees are Fancy.

A winged otter flaps serenely nearby.  His tophat is dapper.

the trees here are no less dusted with snow than their fellows you just pushed through, but they have also been festooned with crystal and glass baubles of every conceivable hue.  Little soft-glowing lights flit from ornament to ornament, keeping the emphasis and shading dynamic.

>look tree
Baubles and glorious gizmos adorn the trees all around this grove.  It may just be you, but they seem to be preening in so far as plants can pose.

* * *

>look trees
Upon closer inspection of a nearby tree, glittering with tinsel made from filaments of actual silver, you note a pair of brilliant green eyes in a feminine face blinking curiously at you from the bark of a nearby tree.  What you had taken to be an odd crystalline growth on the side of the tree resolves itself to be an amethyst necklace cascading down her decolletage like a waterfall's wildness stilled by the gentling influence of frost.  When you raise your eyes to hers again, you find her arching an eyebrow at you.

* * *

>look
Bejeweled Pines
You stand amongst a dazzling array of colors: these trees are Fancy.

A gorgeous dryad peeks out from a nearby tree, curiously.

A winged otter flaps serenely nearby.  His tophat is dapper.

the trees here are no less dusted with snow than their fellows you just pushed through, but they have also been festooned with crystal and glass baubles of every conceivable hue.  Little soft-glowing lights flit from ornament to ornament, keeping the emphasis and shading dynamic.

>look trees
Upon closer inspection of a nearby tree, glittering with tinsel made from filaments of actual silver, you note a pair of brilliant green eyes in a feminine face blinking curiously at you from the bark of a nearby tree.  What you had taken to be an odd crystalline growth on the side of the tree resolves itself to be an amethyst necklace cascading down her decolletage like a waterfall's wildness stilled by the gentling influence of frost.  When you raise your eyes to hers again, you find her arching an eyebrow at you.

* * *

>look greenery
Upon closer inspection of a nearby tree, glittering with tinsel made from filaments of actual silver, you note a pair of brilliant green eyes in a feminine face blinking curiously at you from the bark of a nearby tree.  What you had taken to be an odd crystalline growth on the side of the tree resolves itself to be an amethyst necklace cascading down her decolletage like a waterfall's wildness stilled by the gentling influence of frost.  When you raise your eyes to hers again, you find her arching an eyebrow at you.

* * *

>look tree
Baubles and glorious gizmos adorn the trees all around this grove.  It may just be you, but they seem to be preening in so far as plants can pose.

* * *

>look
Bejeweled Pines
You stand amongst a dazzling array of colors: these trees are Fancy.

A gorgeous dryad peeks out from a nearby tree, curiously.

A winged otter flaps serenely nearby.  His tophat is dapper.

the trees here are no less dusted with snow than their fellows you just pushed through, but they have also been festooned with crystal and glass baubles of every conceivable hue.  Little soft-glowing lights flit from ornament to ornament, keeping the emphasis and shading dynamic.

>say hi to dryad
You can't see any such thing.

* * *

>n
As you try to move away, the winged otter flaps down to block your path, doffing his dapper tophat to you and waving a soft paw shyly.

* * *

>say no creativity to nuvi
His little whiskers droop, and his tophat slides down over his eyes. Pushing it back up into place, he responds, "Oh.  Well, I can't say I'm surprised that you're not able to control elemental creativity.  We'd always hoped that Humanity, as our sires and kinda sorta ancestor god type of things, would be... I dunno, super-crazy-magic, I guess.  That's a childish assumption, however, and there's surely nothing for children in Fuzziolump!"  His snoot wiggles thoughtfully, and then his whiskers spring up so fast they bounce. "Ah well!  It is the nature of things to generally be more realistic than we imagine them, unless of course we're actually imagining them into reality."  He grins at you, as if this was a perfectly normal sentence. "Come on then, let's go see the Council of Animals anyway -- I'm sure you can help us somehow!  They're off North, beyond the Frosted Forest's edge in the sandy savannah of the Wombat Warrens."

>n
Bejeweled Pines
You stand amongst a dazzling array of colors: these trees are Fancy.

the trees here are no less dusted with snow than their fellows you just pushed through, but they have also been festooned with crystal and glass baubles of every conceivable hue.  Little soft-glowing lights flit from ornament to ornament, keeping the emphasis and shading dynamic.

>look tree
Baubles and glorious gizmos adorn the trees all around this grove.  It may just be you, but they seem to be preening in so far as plants can pose.

* * *

>look glow
You can't see any such thing.

* * *

>actions
Actions listing on.

>look dryer
[examining the Dryer]
You see nothing special about the Dryer.

[examining the Dryer - succeeded]

>look whosit
You can't see any such thing.

>say hello
(to yourself)
[answering yourself that "hello"]
There is no reply.
[answering yourself that "hello" - succeeded]

* * *

>look glow
You can't see any such thing.

>actions
Actions listing on.

>look glow
You can't see any such thing.